        ######
#########    #
# $          #
#+ $         #
#.   #########
######