########
#@#    #
# # $  #
#     .#
########