##################
#@  $  .         #
#    $           #
#         .      #
#    #####       #
#    #   #       #
#    $   .       #
#    #   #       #
##################