#######
#.$@  #
###   #
#.##  #
# #   ##
#$ *$  #
#   .  #
########